1111111111101
100100C000001
10000100110C1
1P0011E000000
1111111111111
