1111111111111
1000000000CE1
1000000N00001
1P00000000001
1111111111111
