1111111111111111111111111111111111
1E000N000000000C00N00C00N00000N001
1010010100100000101001000000010101
1010010N1010101000100100000N01N101
1P0000000C00C00000000000N0000000C1
1111111111111111111111111111111111
