1111111111111
100100C000001
10000100110C1
1P0011E000001
1111111111111
