1111111111111111111111111111111111
10000N000000N00C00N00C00N01000N0E1
1010010100100000101001000000010C01
1010010N10101010001001000C0N01N101
1000C0000CC0C00000C00010N0000000C1
1C0000010101000C000000N000C000C001
1PC000000N000111111000C00C01000C01
1C000010000100000N000C00001C000001
1010010N1111111000100100000N01N101
11000C000000000001000C00110000C001
1000C001CC10N0000000C000N0000C0011
111111111111111CCC1111111111111111
1C000C0000C0000C0CC000N00000C000C1
1N0000001C00110N0000011110000N0001
10000C00000C010C0N000C000N00CC00C1
10C0000000000C0000000000C0000000N1
1111111111111111111111111111111111
