1111111111111
1001000000E01
10C00G0011001
1P00110000001
1111111111111
