1111111111111
1001000000E01
1000000011001
1P00110000001
1111111111111
