1111111111111
100100C00001
10000100110C1
1P0011E000001
1111111111111
